1111111111
1000000001
1000000001
10p0p00001
1000000001
1000S00001
1000000011
1000p00001
1000000001
1000000001
1111111111
