111111111111111111111111111111111111111111111111111111111111111111111111111111
100000000000000000000000000000000000000000000000000000000000000000000000000001
100000000000000000000000000000000000000000000000000000000000000000000000000001
100010000S00000000000000000000000000000000000000011000000000000000000000000001
100010000000000000000000000000000000000000000000011000000000000000000000000001
100010000000000000000000000000000000000000000000000000000000000000000000000001
100010000000000000000000000000000000000000000000000000000000000000000000000001
100010000000000000000000000000000000000000000000000000000000000000000000000001
100010000000000000000000000000000000000000000000000000000000000000000000000001
100010000000000000000000000000000000000000000000000000000000000000000000000001
100010000000000000000000000000000000000000000000000000000000000000000000000001
1111100000110000000001100000111111111111111p1111111111111111111110000000000001
111110000011000000000110000011111111111111111111111111111111111110000000000001
111110000011111111111110000011111111111111111111111111111111111110000000000001
111110000011111111111110000011110000000000000000000000000000000000000000000001
100000000000000011000000000001110000000000000000000000000000000000000000000001
100000000000000011000000000001110000000000000000000000000000000000000000000001
100000000000000011000000000000000000000000000000000000000000000000000000000001
100000000000000011000000000000000000000000000000000000000000000000000000000001
100000000000000011000000000000000000000000000000000000000000000000000000000001
100000000000000011000000000000000000000000000000000010000000000000000000000001
100000000000000011000000000000000000000000000000000111000000000000000000000001
100000000000000011000000000000000000000000000000001111100000000000000000000001
100000000000000011000000000000000000000000000000011111110000000000000000000001
100000000000000011000000000000000000000000000000000000000000000000000000000001
100000000000000011000000000000000000000000000000000000000000000000000000000001
100000000000000011000000000000000000000000000000000000000000000000000000000001
100000000000000011000000000000000000000000000000000000000000000000000000000001
111111CC1111111111111111111111111111111111111111111111111111111111111111111111
100000000000000000000000000000000000000000000000000000000000000000001000000001
111111000000000000000000000000000000001110000000000000000000000000001000000001
10000000000000000000000000000000000011111110000000000000000000000000s000000001
10000000000000000000000000000000000011111110000000000000000000000000s000000001
100000000000000000000000000000000000001110000000000000000000000000001111111111
100000000000000000000000000000000000000000000000000000000000000000000000000001
100000000000000000000000000000000000000000000000000000000000000000000000000001
100000000000000000000000000000000000000000000000000000000000000000000000000001
100000000000000000000000000000000000000000000000000000000000000000000000000001
100000000000000000000000000000000000000000000000000000000000000000000000000001
100000000000000000000000000000000000001110000000000000000000000000000000000001
100000000000000000000000000000000000111111100000000000000000000000000000000001
100000000000000000000000000000000000111111100000000000000000000000000000000001
100000000000000000000000000000000000001p10000000000000000000000000000000000001
100000000000000000000000000000000000000000000000000000000000000000000000000001
100000000000000000000000000000000000000000000000000000000000000000000000000001
100000000000000000000000000000000000000000000000000000000000000000000000000001
111111111111111111111111111111111111111111111111111111111111111111111111111111
