1111111111111111111111111111111111111111
1000000000000000000000000000000000000001
100111000000000000S000000000000000111001
1001110000000000000000000000000000111001
1000000000000000000000000000000000000001
1000000000000000000000000000000000000001
1000000000000000000000000000000000000001
1000000000000000000000000000000000000001
1000000000000000000000000000000000000001
1111111111111ss1000000000000000000000001
1000000000000001000000000000000000000001
1000000000000001000000000000000000000001
1000000000000001000000000000000000000001
1111111111111111001111111111111111000001
1000000000000011001000000000000001000001
1000000000000011001000000000000001000001
1000000000000011001000000000000001000001
1000000000000011001000000000000001000001
1000111111111111001000000000000001000001
1000000000000001001111111111111001000001
1000000000000001000000000000001001000001
100000000000000C000000000000001001000001
1000000000000001100000000000001001000001
1000000000000000100000000000001001000001
1100000000000000100000000000001001000001
1p00000000000000100000000000001001000001
1100000000000000100000000000001001000001
1111111110011000100000000000001001C111C1
1000000010011000100000000000001001000001
1000000010011000100000000000001001000001
1000000010011000100000000000001001000001
1000000010011000100000000000001001000001
100000001000000011111111111ss11001000001
1000000010000000000010000000000001000001
1000000010000000000010000000000001000001
1000000010000000000010000000000001000001
1000000110000000000010000000000001000001
1000000p10000000000010000000000001000001
1000000110000000000010000000000001000001
1000000010000000000010000000000001000001
1111111111111111111111111111111111111111
