111111111111111111111111111111111111
100000000000000001100000000000000001
100000000000000001100000000000000001
100111100111111001100111111001111001
100111100111111001100111111001111001
100000000000000000000000000000000001
100000000000000000000000000000000001
100111100110011111111110011001111001
100000000110000001100000011000000001
100000000110000001100000011000000001
111111100111111001100111111001111111
100000100110000000000000011001000001
100000100110000000000000011001000001
100000100110011100001110011001000001
111111100110010000000010011001111111
10000000000001000S000010000000000001
100000000000010000000010000000000001
111111100110010000000010011001111111
100000100110011111111110011001000001
100000100110000000000000011001000001
100000100110000000000000011001000001
111111100110011111111110011001111111
100000000000000001100000000000000001
100000000000000001100000000000000001
100111100111111001100111111001111001
100001100000000000000000000001100001
100001100000000000000000000001100001
111001100110011111111110011001100111
100000000110000001100000011000000001
100000000110000001100000011000000001
100111111111111001100111111111111001
100000000000000000000000000000000001
100000000000000000000000000000000001
111111111111111111111111111111111111
